AD|ANDORRA|ANDORRA|ANDORRA
AE|EMIRADOS ÁRABES UNIDOS|UNITED ARAB EMIRATES|EMIRATOS ARABES UNIDOS
AF|AFEGANISTÃO|AFGHANISTAN|AFGANISTAN
AG|ANTÍGUA E BARBUDA|ANTIGUA|ANTIGUA Y BARBUDA
AI|ANGUILLA
AL|ALBÂNIA|ALBANIA|ALBANIA
AM|ARMÊNIA|ARMENIA|ARMENIA
AN|ANTILHAS HOLANDESAS|NETHERLANDS ANTILLES|ANTILLAS NEERLANDESAS
AO|ANGOLA|ANGOLA|ANGOLA
AQ|ANTÁRTICA|ANTARCTIC REGIONS|REGIONES ANTARTICAS
AR|ARGENTINA|ARGENTINA|ARGENTINA
AS|SAMOA AMERICANA|AMERICAN SAMOA|SAMOA AMERICANA
AT|ÁUSTRIA|AUSTRIA|AUSTRIA
AU|AUSTRÁLIA|AUSTRALIA|AUSTRALIA
AW|ARUBA
AZ|AZERBAIDJÃO|AZERBAIJAN|AZERBAIYAN
BA|BÓSNIA-HERZEGÓVINA|BOSNIA-HERZEGOVINA|BOSNIA-HERZEGOVINA
BB|BARBADOS|BARBADOS|BARBADOS
BD|BANGLADESH|BANGLADESH|BANGLADESH
BE|BÉLGICA|BELGIUM|BELGICA
BF|BURKINA FASSO|BURKINA FASO|BURQUINA FASO
BG|BULGÁRIA|BULGARIA|BULGARIA
BH|BAREIN|BAHRAIN|BAHREIN
BI|BURUNDI|BURUNDI|BURUNDI
BJ|BENIN|BENIN|BENIN
BM|BERMUDAS|BERMUDA|BERMUDAS
BN|BRUNEI|BRUNEI|BRUNEI
BO|BOLÍVIA|BOLIVIA|BOLIVIA
BR|BRASIL|BRAZIL|BRASIL|BRESIL|BRASILE
BS|BAHAMAS|BAHAMAS|BAHAMAS
BT|BUTÃO|BHUTAN|BUTAN
BV|ILHA BOUVET
BW|BOTSUANA|BOTSWANA|BOTSWANA
BY|BELARUS|BYELARUS|BELARUS
BZ|BELIZE|BELIZE|BELICE
CA|CANADÁ|CANADA|CANADA
CC|ILHAS COCOS
CD|REPÚBLICA DEMOCRÁTICA DO CONGO|DEMOCRATIC REPUBLIC OF THE CONGO|REPUBLICA DEMOCRATICA DEL CONGO
CF|REPÚBLICA CENTRO-AFRICANA|CENTRAL AFRICAN REPUBLIC|REPUBLICA CENTRO AFRICANA
CG|CONGO|CONGO|CONGO
CH|SUÍÇA|SWITZERLAND|SUIZA
CI|COSTA DO MARFIM|COTE D'IVOIRE|COSTA DE MARFIL
CK|ILHAS COOK
CL|CHILE|CHILE|CHILE
CM|CAMARÕES|CAMEROON|CAMERUN
CN|CHINA|CHINA|CHINA
CO|COLÔMBIA|COLOMBIA|COLOMBIA
CR|COSTA RICA|COSTA RICA|COSTA RICA
CU|CUBA|CUBA|CUBA
CV|CABO VERDE|CAPE VERDE|CABO VERDE
CX|ILHA CHRISTMAS
CY|CHIPRE|CYPRUS|CHIPRE
CZ|REPÚBLICA TCHECA|CZECH REPUBLIC|REPUBLICA CHECA
DE|ALEMANHA|GERMANY|ALEMANIA
DJ|DJIBUTI|DJIBOUTI|DJIBOUTI
DK|DINAMARCA|DENMARK|DINAMARCA
DM|DOMINICA|DOMINICA|DOMINICA
DO|REPÚBLICA DOMINICANA|DOMINICAN REPUBLIC|REPUBLICA DOMINICANA
DZ|ARGÉLIA|ALGERIA|ARGELIA
EC|EQUADOR|ECUADOR|ECUADOR
EE|ESTÔNIA|ESTONIA|ESTONIA
EG|EGITO|EGYPT|EGIPTO
EH|SAARA OCIDENTAL
ER|ERITRÉIA|ERITREA|ERITREA
ES|ESPANHA|SPAIN|ESPAÑA
ET|ETIÓPIA|ETHIOPIA|ETIOPIA
FI|FINLÂNDIA|FINLAND|FINLANDIA
FJ|FIJI|FIJI|FIDJI
FK|ILHAS MALVINAS|FALKLAND ISLANDS|ISLAS MALVINAS
FM|MICRONÉSIA|MICRONESIA|MICRONESIA
FO|ILHAS FAROE|FAEROE ISLANDS|ISLAS FEROE
FR|FRANÇA|FRANCE|FRANCIA
GA|GABÃO|GABON|GABON
GB|REINO UNIDO|GREAT BRITAIN|REINO UNIDO|UK|UNITED KINGDOM
GD|GRANADA|GRENADA|GRENADA
GE|GEÓRGIA|GEORGIA|GEORGIA
GF|GUIANA FRANCESA|FRENCH GUIANA|GUYANA FRANCESA
GH|GANA|GHANA|GHANA
GI|GIBRALTAR|GIBRALTAR|GIBRALTAR
GL|GROENLÂNDIA|GREENLAND|GROENLANDIA
GM|GÂMBIA|GAMBIA|GAMBIA
GN|GUINÉ|GUINEA|GUINEA
GP|GUADALUPE|GUADELOUPE|GUADALUPE
GQ|GUINÉ EQUATORIAL|EQUATORIAL GUINEA|GUINEA ECUATORIAL
GR|GRÉCIA|GREECE|GRECIA
GS|ILHA GEÓRGIA DO SUL E ILHAS SANDWICH DO SUL
GT|GUATEMALA|GUATEMALA|GUATEMALA
GU|GUAM|GUAM|GUAM
GW|GUINÉ-BISSAU|GUINEA-BISSAU|GUINEA BISSAU
GY|GUIANA|GUYANA|GUYANA
HK|HONG KONG|HONG KONG|HONG KONG
HM|ILHAS HEARD E MC DONALD
HN|HONDURAS|HONDURAS|HONDURAS
HR|CROÁCIA|CROATIA|CROACIA
HT|HAITI|HAITI|HAITI
HU|HUNGRIA|HUNGARY|HUNGRIA
ID|INDONÉSIA|INDONESIA|INDONESIA
IE|IRLANDA|IRELAND|IRLANDA
IL|ISRAEL|ISRAEL|ISRAEL
IN|ÍNDIA|INDIA|INDIA
IO|TERRITÓRIO BRITÂNICO DO OCEANO ÍNDICO
IQ|IRAQUE|IRAQ|IRAK
IR|IRÃ|IRAN|IRAN
IS|ISLÂNDIA|ICELAND|ISLANDIA
IT|ITÁLIA|ITALY|ITALIA
JM|JAMAICA|JAMAICA|JAMAICA
JO|JORDÂNIA|JORDAN|JORDANIA
JP|JAPÃO|JAPAN|JAPON
KE|QUÊNIA|KENYA|KENIA
KG|QUIRGUISTÃO|KYRGYZSTAN|KIRGUISTAN
KH|CAMBOJA|CAMBODIA|CAMBODIA
KI|KIRIBATI|KIRIBATI|KIRIBATI
KM|COMORES|COMOROS|COMOROS
KN|SÃO CRISTÓVÃO E NEVIS|SAINT KITTS AND NEVIS|SAN KITTS Y NEVIS
KP|CORÉIA DO NORTE|NORTH KOREA|COREA DEL NORTE
KR|CORÉIA DO SUL|SOUTH KOREA|COREA DEL SUR
KW|KUWEIT|KUWAIT|KUWAIT
KY|ILHAS CAYMAN
KZ|CAZAQUISTÃO|KAZAKHSTAN|KAZAJSTAN
LA|LAOS|LAOS|LAOS
LB|LÍBANO|LEBANON|LIBANO
LC|SANTA LÚCIA|SAINT LUCIA|SANTA LUCIA
LI|LIECHTENSTEIN|LIECHTENSTEIN|LIECHTENSTEIN
LK|SRI LANKA|SRI LANKA|SRI LANKA
LR|LIBÉRIA|LIBERIA|LIBERIA
LS|LESOTO|LESOTHO|LESOTHO
LT|LITUÂNIA|LITHUANIA|LITUANIA
LU|LUXEMBURGO|LUXEMBOURG|LUXEMBURGO
LV|LETÔNIA|LATVIA|LETONIA
LY|LÍBIA|LIBYA|LIBIA
MA|MARROCOS|MOROCCO|MARRUECOS
MC|MÔNACO|MONACO|MONACO
MD|MOLDÁVIA|MOLDOVA|MOLDOVA
MG|MADAGÁSCAR|MADAGASCAR|MADAGASCAR
MH|ILHAS MARSHALL|MARSHALL ISLANDS|ISLAS MARSHALL
MK|MACEDÔNIA (REPÚBLICA)|MACEDONIA (REPUBLIC)|MACEDONIA (REPUBLICA)
ML|MALI|MALI|MALI
MM|MIANMAR|MYANMAR|MIANMAR
MN|MONGÓLIA|MONGOLIA|MONGOLIA
MO|MACAU|MACAO|MACAO
MP|ILHAS MARIANAS DO NORTE|MARIANA ISLANDS|ISLAS MARIANAS
MQ|MARTINICA|MARTINIQUE|MARTINICA
MR|MAURITÂNIA|MAURITANIA|MAURITANIA
MS|MONTSERRAT
MT|MALTA|MALTA|MALTA
MU|MAURÍCIO|MAURITIUS|MAURICIO
MV|MALDIVAS|MALDIVES|MALDIVAS
MW|MALAUÍ|MALAWI|MALAWI
MX|MÉXICO|MEXICO|MEXICO
MY|MALÁSIA|MALAYSIA|MALASIA
MZ|MOÇAMBIQUE|MOZAMBIQUE|MOZAMBIQUE
NA|NAMÍBIA|NAMIBIA|NAMIBIA
NC|NOVA CALEDÔNIA|NEW CALEDONIA|NUEVA CALEDONIA
NE|NÍGER|NIGER|NIGER
NF|ILHA NORFOLK
NG|NIGÉRIA|NIGERIA|NIGERIA
NI|NICARÁGUA|NICARAGUA|NICARAGUA
NL|HOLANDA|NETHERLANDS|PAISES BAJOS
NO|NORUEGA|NORWAY|NORUEGA
NP|NEPAL|NEPAL|NEPAL
NR|NAURU|NAURU|NAURU
NU|NIUE
NZ|NOVA ZELÂNDIA|NEW ZEALAND|NUEVA ZELANDA
OM|OMÃ|OMAN|OMAN
PA|PANAMÁ|PANAMA|PANAMA
PE|PERU|PERU|PERU
PF|POLINÉSIA|POLYNESIA|POLINESIA
PG|PAPUA NOVA GUINÉ|PAPUA NEW GUINEA|PAPUA NUEVA GUINEA
PH|FILIPINAS|PHILIPPINES|FILIPINAS
PK|PAQUISTÃO|PAKISTAN|PAKISTAN
PL|POLÔNIA|POLAND|POLONIA
PM|SAINT PIERRE E MIQUELON|SAINT PIERRE AND MIQUELON|SAINT PIERRE Y MIQUELON
PN|PITCAIRN|PITCAIRN ISLAND|ISLA PITCAIRN
PR|PORTO RICO|PUERTO RICO|PUERTO RICO
PS|TERRITÓRIO PALESTINO OCUPADO
PT|PORTUGAL|PORTUGAL|PORTUGAL
PW|PALAU|PALAU|PALAU
PY|PARAGUAI|PARAGUAY|PARAGUAY
QA|CATAR|QATAR|QATAR
RE|REUNIÃO|REUNION|REUNION
RO|ROMÊNIA|ROMANIA|RUMANIA
RU|FEDERAÇÃO RUSSA|RUSSIA|RUSIA
RW|RUANDA|RWANDA|RWANDA
SA|ARÁBIA SAUDITA|SAUDI ARABIA|ARABIA SAUDITA
SB|ILHAS SALOMÃO|SOLOMON ISLANDS|ISLAS SALOMON
SC|SEICHELES|SEYCHELLES|SEYCHELLES
SD|SUDÃO|SUDAN|SUDAN
SE|SUÉCIA|SWEDEN|SUECIA
SG|SINGAPURA|SINGAPORE|SINGAPUR
SH|SANTA HELENA
SI|ESLOVÊNIA|SLOVENIA|ESLOVENIA
SJ|SVALBARD E JAN MAYEN|SVALBARD|SVALBARD
SK|ESLOVÁQUIA|SLOVAKIA|ESLOVAQUIA
SL|SERRA LEOA|SIERRA LEONE|SIERRA LEONA
SM|SAN MARINO|SAN MARINO|SAN MARINO
SN|SENEGAL|SENEGAL|SENEGAL
SO|SOMÁLIA|SOMALIA|SOMALIA
SR|SURINAME|SURINAME|SURINAME
ST|SÃO TOMÉ E PRÍNCIPE
SV|EL SALVADOR|EL SALVADOR|EL SALVADOR
SY|SÍRIA|SYRIA|SIRIA
SZ|SUAZILÂNDIA|SWAZILAND|SWAZILANDIA
TC|ILHAS TURKS E CAICOS
TD|CHADE|CHAD|CHAD
TF|TERRAS AUTRAIS E ANTÁRTICAS DA FRANÇA
TG|TOGO|TOGO|TOGO
TH|TAILÂNDIA|THAILAND|TAILANDIA
TJ|TADJIQUISTÃO|TAJIKISTAN|TAYIKISTAN
TK|TOQUELAU
TM|TURCOMENISTÃO|TURKMENISTAN|TURKMENISTAN
TN|TUNÍSIA|TUNISIA|TUNEZ
TO|TONGA|TONGA|TONGA
TP|TIMOR LESTE|EAST TIMOR|TIMOR ORIENTAL
TR|TURQUIA|TURKEY|TURQUIA
TT|TRINIDAD E TOBAGO|TRINIDAD AND TOBAGO|TRINIDAD Y TOBAGO
TV|TUVALU|TUVALU|TUVALU
TW|TAIWAN|TAIWAN|TAIWAN
TZ|TANZÂNIA|TANZANIA|TANZANIA
UA|UCRÂNIA|UKRAINE|UCRANIA
UG|UGANDA|UGANDA|UGANDA
UM|ILHAS MENORES DISTANTES DOS EUA
US|ESTADOS UNIDOS|UNITED STATES|ESTADOS UNIDOS|USA|EUA
UY|URUGUAI|URUGUAY|URUGUAY
UZ|UZBEQUISTÃO|UZBEKISTAN|UZBEQUISTAN
VA|VATICANO|VATICAN CITY|CIUDAD DEL VATICANO
VC|SÃO VICENTE E GRANADINAS|SAINT VINCENT AND THE GRENADINES|SAN VICENTE Y LAS GRENADINAS
VE|VENEZUELA|VENEZUELA|VENEZUELA
VG|ILHAS VIRGENS BRITÂNICAS|VIRGIN ISLANDS, BRITISH|ISLAS VIRGENES BRITANICAS
VI|ILHAS VIRGENS AMERICANAS|VIRGIN ISLANDS OF THE UNITED STATES|ISLAS VIRGENES DE LOS ESTADOS UNIDOS
VN|VIETNÃ|VIETNAM|VIETNAM
VU|VANUATU|VANUATU|VANUATU
WF|ILHAS WALLIS E FUTUNA
WS|SAMOA|SAMOA|SAMOA
YE|IÊMEN|YEMEN|YEMEN
YT|MAYOTTE|MAYOTTE|MAYOTTE
YU|IUGOSLÁVIA|YUGOSLAVIA|YUGOSLAVIA
ZA|ÁFRICA DO SUL|SOUTH AFRICA|SUDAFRICA
ZM|ZÂMBIA|ZAMBIA|ZAMBIA
ZW|ZIMBÁBUE|ZIMBABWE|ZIMBABWE
